0000000000000000
0000000000000000
9111111111000000
0000000001000000
0000000001000000
0000000001000000
0000000001000000
0000000001111110
0000000000000010
0000000000081110
0000000000000000
reverse!
1 1 2 2 2 2 2 2 1 1 1 2 3 3 3
