0000000000000090
0000000000000010
0000000000000010
0000000000000010
0000011111111110
0000010000000000
0000010000000000
0000010000000000
0000010000000000
8111110000000000
0000000000000000
reverse!
1 1 1 1 1 1 1 1 1 2 2 2 2 3 3 3 3 3 3 3 3 3 1 1 1 1 1 1  2 3 4 4 4
