0000000000000080
0000000000000010
0000011111111110
0000010000000000
0000010000000000
0000010000000000
0000010000000000
0000010000000000
0000010000000000
9111110000000000
0000000000000000
reverse!
1 1 1 2 3 1 1 2 3 3 3
